1111111
1000001
10x0001
1111101
100y001
1000001
1111111